+----------------------------------------------------------+
|     h  g  f  e  d  c  b  a      ||======================||
|   +------------------------+    || ```````````````````` ||
|   |...   ...   ...   ...   |    ||         Turn         ||
| 1 |.@. @ .@. @ .@. @ .@. @ | 1  ||======================||
|   |...   ...   ...   ...   |    ||                      ||
|   |   ...   ...   ...   ...|    || TTTTTTTTTTTTTTTTTTTT ||
| 2 | @ .@. @ .@. @ .@. @ .@.| 2  ||                      ||
|   |   ...   ...   ...   ...|    ||===----------------===||
|   |...   ...   ...   ...   |    ||                      ||
| 3 |.@. @ .@. @ .@. @ .@. @ | 3  ||  Pieces taken by W:  ||
|   |...   ...   ...   ...   |    ||   wwwwwwwwwwwwwwww   ||
|   |   ...   ...   ...   ...|    ||                      ||
| 4 | @ .@. @ .@. @ .@. @ .@.| 4  ||  Pieces taken by B:  ||
|   |   ...   ...   ...   ...|    ||   bbbbbbbbbbbbbbbb   ||
|   |...   ...   ...   ...   |    ||                      ||
| 5 |.@. @ .@. @ .@. @ .@. @ | 5  ||===----------------===||
|   |...   ...   ...   ...   |    ||                      ||
|   |   ...   ...   ...   ...|    ||      Games won:      ||
| 6 | @ .@. @ .@. @ .@. @ .@.| 6  ||                      ||
|   |   ...   ...   ...   ...|    || PPPPPPPPPPPPPPPPPPPP ||
|   |...   ...   ...   ...   |    ||  !!!!!!!!!!!!!!!!!!  ||
| 7 |.@. @ .@. @ .@. @ .@. @ | 7  ||                      ||
|   |...   ...   ...   ...   |    || pppppppppppppppppppp ||
|   |   ...   ...   ...   ...|    ||  ;;;;;;;;;;;;;;;;;;  ||
| 8 | @ .@. @ .@. @ .@. @ .@.| 8  ||                      ||
|   |   ...   ...   ...   ...|    ||======================||
|   +------------------------+    || ^^^^^^^^^^^^^^^^^^^^ ||
|     h  g  f  e  d  c  b  a      ||======================||
+----------------------------------------------------------+